R 1280 720
NO ./textures/gemsparksapphirewall.xpm   
SO ./textures/sapphirewall.xpm
WE ./textures/gemsparkamethystwall.xpm
EA ./textures/amethystwall.xpm
C 200,200,200
S ./textures/coin.xpm
F ./textures/gemsparkdiamondfloor.xpm
        1111111111111111111111111
        1000000002110000000000001
        1011000001110002000002001
        1001000000000000000000001
111111111011020001110000000000001
1E0000000011000001110111111111111
11110111111111011100000000001
11110111111111011101010010001
11000000110101011100000010001
10200000000000001100000010001
10000000000000001101010010001
1100000111010101111101111000111
11110111 1110101 101111010201
11111111 1111111 111111111111