R 1600 800
NO cub3d_tester_bonus/textures/wall_1.xpm
SO cub3d_tester_bonus/textures/wall_2.xpm
WE cub3d_tester_bonus/textures/wall_3.xpm
EA cub3d_tester_bonus/textures/wall_4.xpm
S cub3d_tester_bonus/textures/sprite_1.xpm
F cub3d_tester_bonus/textures/floor.xpm
C 51,198,227

1111111111111
1020000000021
100000N000001

1000002000001
1111111111111
