NO cub3d_tester/textures/wall_1.xpm
SO cub3d_tester/textures/wall_2.xpm
WE cub3d_tester/textures/wall_3.xpm
EA cub3d_tester/textures/wall_4.xpm

F a184,113,39
C 51,198,227

1111111111111
1000000000001
100N000000001
1000000000001
1111111111111